# Map file for tile-based game
# (Lines that start with '#' are comments)
# The tiles are:
#   (Space) Empty tile
#   A Center Tile
#   B Top Tile                            G B F   _	     _	  _	          _
#   C Bottom Tile		                      E A D	  _| J  |_ K	_ L  | | Q |_| R
#   D Right Tile		                      I C H
#   E Left Tile
#   F Right Top Corner Tile
#   G Left Top Corner Tile
#   H Right Bottom Corner Tile
#   I Left Bottom Corner Tile
#   J All But Left Tile
#   K All But Right Tile
#   L Top and Bottom Tile
#   M Right Top Dot Tile
#   N Left Top Dot Tile
#   O Left Bottom Dot Tile
#   P Right Bottom Dot Tile
#   Q Both Sides Tiles
#   R All Sides Tiles
#   S Trap
#   T Player Dies
#   1 Chunguillo
#   2 Bad Ass
#   3 Boss
#   ! Speed Power Up
#   o Health Power Up                                                                                                                      
                                                                                                                      
                                                                                                                      
                                                                                                                      
                                                                                                                      
                                                                                                                      
                                                                                  2       o                           
                        1                                                   GBBBBBBBBBBBBBBF                          
                    GBBBBF                                         KLJ      EAAAAAAAAAAAAAAD                          
                   GNAPCCH                                                  EAAAAAAAAAAAAAAD                          
BBBBF   !      2 GBNAAD             2       1       2                     GBNAAAAAAAAAAAAAAD                          
AAAAMBBBBF  GBBBBNAAAAD           KBBBBBBBBBBBBBBBBBBBBBBBBBBLJ         GBNAAAAAAAAAAAAAAAAD                          
AAAAAAAAAD  EAAAAAAAAAD            ICCOAAAAAAAAAAAAAAAAAAAPCH           EAAAAAAAAAAAAAAAAAAD                          
AAAAAAAAAD  EAAAAAAAAAMF              ICCCCCCCCCCCCCCCCCCCH           GBNAAAAAAAAAAAAAAAAAAD                          
AAAAAAAAAD  EAAAAAAAAAAD                                              EAAAAAAAAAAAAAAAAAAAAD                          
AAAAAAAAAD  EAAAAAAAAAAMF                                           GBNAAAAAAAAAAAAAAAAAAAAD                          
AAAAAAAAAD  EAAAAAAAAAAAD                                           EAAAAAAAAAAAAAAAAAAAAAAD                          
AAAAAAAAAD  EAAAAAAAAAAAMBBF                                      GBNAAAAAAAAAAAAAAAAAAAAAAD                          
AAAAAAAAAD  EAAAAAAAAAAAAAAMBBF                                 GBNAAAAAAAAAAAAAAAAAAAAAAAAD                        GS
AAAAAAAAAD  EAAAAAAAAAAAAAAAAAD                                 EAAAAAAAAAAAAAAAAAAAAAAAAAAD                      3 Q*
AAAAAAAAAD  EAAAAAAAAAAAAAAAAAMBBF    2       1    1      2   GBNAAAAAAAAAAAAAAAAAAAAAAAAAAMBBBBBBBBBBBBBBBBBBBBBBBBBB
AAAAAAAAAD  EAAAAAAAAAAAAAAAAAAAAMBBBBBBBBBBBBBBBBBBBBBBBBBBBBNAAAAAAAAAAAAAAAAAAAAAAAAAAAAAAAAAAAAAAAAAAAAAAAAAAAAAAA
AAAAAAAAAD  EAAAAAAAAAAAAAAAAAAAAAAAAAAAAAAAAAAAAAAAAAAAAAAAAAAAAAAAAAAAAAAAAAAAAAAAAAAAAAAAAAAAAAAAAAAAAAAAAAAAAAAAAA
AAAAAAAAAD  EAAAAAAAAAAAAAAAAAAAAAAAAAAAAAAAAAAAAAAAAAAAAAAAAAAAAAAAAAAAAAAAAAAAAAAAAAAAAAAAAAAAAAAAAAAAAAAAAAAAAAAAAA
AAAAAAAAAD  EAAAAAAAAAAAAAAAAAAAAAAAAAAAAAAAAAAAAAAAAAAAAAAAAAAAAAAAAAAAAAAAAAAAAAAAAAAAAAAAAAAAAAAAAAAAAAAAAAAAAAAAAA
AAAAAAAAADTTEAAAAAAAAAAAAAAAAAAAAAAAAAAAAAAAAAAAAAAAAAAAAAAAAAAAAAAAAAAAAAAAAAAAAAAAAAAAAAAAAAAAAAAAAAAAAAAAAAAAAAAAAA
