# Map file for tile-based game
# (Lines that start with '#' are comments)
# The tiles are:
#   (Space) Empty tile
#   A Center Tile
#   B Top Tile                            G B F   _	     _	  _	          _
#   C Bottom Tile		                      E A D	  _| J  |_ K	_ L  | | Q |_| R
#   D Right Tile		                      I C H
#   E Left Tile
#   F Right Top Corner Tile
#   G Left Top Corner Tile
#   H Right Bottom Corner Tile
#   I Left Bottom Corner Tile
#   J All But Left Tile
#   K All But Right Tile
#   L Top and Bottom Tile
#   M Right Top Dot Tile
#   N Left Top Dot Tile
#   O Left Bottom Dot Tile
#   P Right Bottom Dot Tile
#   Q Both Sides Tiles
#   R All Sides Tiles
#   S Trap
#   T Player Dies
#   1 Chunguillo
#   2 Bad Ass
#   3 Boss
#   ! Speed Power Up
#   o Health Power Up
#   * Pass to next Level
                          
                          
                          
BF                      GB
AMBF                  GBNA
AAAD                  EAAA
AAAD            1     EAAA
AAAD           KLJ    EAAA
AAAD                  EAAA
AAAD  2               EAAA
AAAMLLLLJ             EAAA
AAAD                  EAAA
AAAD                  EAAA
AAAD                  EAAA
AAAD               2  EAAA
AAAD             KLLLLNAAA
AAAD   KLJ            EAAA
AAAD                  EAAA
AAAD               2  EAAA
AAAD      1       KLJ EAAA
AAAD     GBBF         EAAA
AAAD     EAAD         EAAA
AAAD     ICCH         EAAA
AAAD                  EAAA
AAAD                  EAAA
AAAD            KLJ   EAAA
AAAD                  EAAA
AAAD 2                EAAA
AAAMLLJ               EAAA
AAAD                  EAAA
AAAD              KLLLNAAA
AAAD                  EAAA
AAAD                  EAAA
AAAD     1            EAAA
AAAD   KLLJ           EAAA
AAAD                  EAAA
AAAD                  EAAA
AAAD       KLJ        EAAA
AAAD                  EAAA
AAAD            2     EAAA
AAAD           KLLJ   EAAA
AAAD                  EAAA
AAAD      KLLJ        EAAA
AAAD                  EAAA
AAAD KLLJ             EAAA
AAAD                  EAAA
AAAD                  EAAA
AAAD               3  EAAA
AAAMSBBBBBBBBBBBBBBBBBNAAA
AAAD EAAAAAAAAAAAAAAAAAAAA
AAAD EAAAAAAAAAAAAAAAAAAAA
AAAD EAAAAAAAAAAAAAAAAAAAA
AAAD EAAAAAAAAAAAAAAAAAAAA
AAAD EAAAAAAAAAAAAAAAAAAAA
AAAD EAAAAAAAAAAAAAAAAAAAA
AAAD*EAAAAAAAAAAAAAAAAAAAA
